011111111111111000000000000000
010000000000001000000000000000
010000000000001000000000000000
010000000000001000000000000000
010000000000001000000000000000
011111111111111000000111100000
000000000100001000000100100000
000000000100001000000100111111
000000000111111111000100100001
000000000101001001000100100001
000000000101001001000100100001
000000000111111111111100100001
000000000101001001000100100001
000000000101001001000100100001
000000000101111111000100100001
000000000101001000000111100001
000000000101001111111100111111
000000000101001000000000000000
000000000101001000000000000000
000000000111111111111111111110
000000000100001000000000000010
000000000100001000000000000010
000000000100001000000000000010
000000000100001000000000000010
000111111111111000000000000010
000100000100001000000000000010
000100000100001111111111111110
000111111100000000000000000000
